{
	"world":
	{
		"background":"images/backgrounds/bg_flat.png",
		"tileset":"images/tileset1.png",
		"frame_w":32,
		"frame_h":32,
		"frames_per_line":16,
		"tileMap":
	[
		[1, 1, 1, 1, 1, 1, 1, 1, 1, 1, 1, 1, 1, 1, 1, 1],
		[1, 0, 0, 0, 0, 0, 0, 0, 0, 0, 0, 0, 0, 0, 0, 1],
		[1, 0, 0, 0, 0, 0, 0, 0, 0, 0, 0, 0, 0, 0, 0, 1],
		[1, 0, 0, 0, 0, 0, 0, 0, 0, 0, 0, 0, 0, 0, 0, 1],
		[1, 0, 0, 0, 0, 0, 0, 0, 0, 0, 0, 0, 0, 0, 0, 1],
		[1, 0, 0, 0, 0, 0, 0, 0, 0, 0, 0, 0, 0, 0, 0, 1],
		[1, 0, 0, 0, 0, 0, 0, 0, 0, 0, 0, 0, 0, 0, 0, 1],
		[1, 1, 1, 1, 0, 0, 0, 0, 0, 0, 0, 0, 0, 0, 0, 1],
		[1, 3, 3, 1, 2, 2, 2, 2, 2, 2, 2, 2, 2, 2, 2, 1],
		[1, 3, 3, 1, 1, 2, 2, 2, 2, 2, 2, 2, 2, 2, 1, 1],
		[1, 1, 1, 1, 1, 1, 1, 1, 1, 1, 1, 1, 1, 1, 1, 1]
	]
	}
}